N0300,N0300,N0300,N0300,N0300,N0300,N0300,N0300
N0300,N0300,N0300,N0300,N0300,N0300,N0300,N0300
N0300,N0300,N0300,N0300,N0300,N0300,N0300,N0300
N0300,N0300,M0100,M0100,N0300,N0300,N0300,N0300
N0300,N0300,N0300,N0300,N0300,N0300,N0300,N0300
N0300,N0300,N0300,F0100,W0200,N0300,N0300,N0300
N0300,N0300,N0300,M0300,M0300,P0100,N0300,N0300
N0300,N0300,N0300,M0300,M0300,M0300,N0300,N0300,N0300
