N0300,N0300,N0300,N0300,N0300,N0300,N0300,N0300
N0300,N0300,N0300,N0300,N0300,N0300,N0300,N0300
N0300,N0300,N0300,N0300,N0300,N0300,N0300,N0300
N0300,N0300,M0100,M0100,N0300,N0300,N0300,N0300
N0300,N0300,N0300,N0300,N0300,N0300,N0300,N0300
N0300,N0300,N0300,N0300,N0300,N0300,N0300,N0300
N0300,N0300,N0300,M0300,N0300,N0300,N0300,N0300
N0300,N0300,N0300,M0300,M0300,N0300,N0300,N0300
