P0300,P0300,P0300,P0300,P0300,P0300,P0300,P0300,P0300,P0300,P0300,P0300,P0300,P0300,P0300,P0300,P0300,P0300,P0300,P0200,M0300,M0300,M0300
P0300,P0300,P0300,P0300,P0300,P0300,P0300,P0300,P0300,P0300,P0300,P0300,P0300,P0300,P0300,P0300,P0300,P0300,P0200,P0200,M0300,M0300,M0300
P0300,P0300,P0300,P0300,P0300,P0300,P0300,P0300,P0300,P0300,P0300,P0300,P0300,P0300,P0300,P0300,P0300,P0300,P0200,M0300,M0300,M0300,P0200
P0300,P0300,P0300,P0300,P0300,P0300,P0300,P0300,P0300,P0300,P0300,P0300,P0300,P0300,P0300,P0300,P0200,P0200,P0200,M0300,M0300,M0300,P0200
P0300,P0300,P0300,P0300,P0300,P0300,P0300,P0300,P0300,P0300,P0300,P0300,P0300,P0300,P0300,P0300,P0200,M0300,M0300,M0300,M0300,P0200,P0200
P0300,P0300,P0300,P0300,P0300,P0300,P0300,P0300,P0300,P0300,P0300,P0300,P0300,P0300,P0300,P0200,P0200,M0300,M0300,M0300,M0300,P0200,P0300
P0300,P0300,P0300,P0300,P0300,P0300,P0300,P0300,P0300,P0300,P0300,P0300,P0300,P0300,P0300,P0200,M0300,M0300,M0300,P0200,P0200,P0200,P0300
P0300,P0300,P0300,P0300,P0300,P0300,P0300,P0300,P0300,P0300,P0300,P0300,P0300,P0200,P0200,P0200,M0300,M0300,M0300,P0200,P0300,P0300,P0300
P0300,P0300,P0300,P0300,P0300,P0300,P0300,P0300,P0300,P0300,P0300,P0300,P0300,P0200,M0300,M0300,M0300,P0200,P0200,P0200,P0300,P0300,P0300
P0300,P0300,P0300,P0300,P0300,P0300,P0300,P0300,P0300,P0300,P0300,P0300,P0200,P0200,M0300,M0300,M0300,P0200,P0300,P0300,P0300,P0300,P0300
P0300,P0300,P0300,P0300,P0300,P0300,P0300,P0300,P0300,P0300,P0300,P0300,P0200,M0300,M0300,M0300,P0200,P0200,P0300,P0300,P0300,P0300,P0300
P0300,P0300,P0300,P0300,P0300,P0300,P0300,P0300,P0300,P0300,P0300,P0200,P0200,M0300,M0300,M0300,P0200,P0300,P0300,P0300,P0300,P0300,P0300
P0300,P0300,P0300,P0300,P0300,P0300,P0300,P0300,P0300,P0300,P0300,P0200,M0300,M0300,M0300,P0200,P0200,P0300,P0300,P0300,P0300,P0300,P0300
P0300,P0300,P0300,P0300,P0300,P0300,P0300,P0300,P0300,P0300,P0300,P0200,M0300,M0300,M0300,P0200,P0300,P0300,P0300,P0300,P0300,P0300,P0300
P0300,P0300,P0300,P0300,P0300,P0300,P0300,P0300,P0300,P0300,P0200,P0200,M0300,M0300,M0300,P0200,P0300,P0300,P0300,P0300,P0300,P0300,P0300
P0300,P0300,P0300,P0300,P0300,P0300,P0300,P0300,P0300,P0300,P0200,M0300,M0300,M0300,P0200,P0200,P0300,P0300,P0300,P0300,P0300,P0300,P0300
P0300,P0300,P0300,P0300,P0300,P0300,P0300,P0300,P0300,P0300,P0200,M0300,M0300,M0300,P0200,P0300,P0300,P0300,P0300,P0300,P0300,P0300,P0300
P0300,P0300,P0300,P0300,P0300,P0300,P0300,P0300,P0300,P0200,P0200,M0300,M0300,M0300,P0200,P0300,P0300,P0300,P0300,M0202,M0202,M0202,P0300
P0300,P0300,P0300,P0300,P0300,P0300,P0300,P0300,P0300,P0200,M0300,M0300,M0300,P0200,P0200,P0300,P0300,P0300,P0300,M0202,P0300,P0300,P0300
P0300,P0300,P0300,P0300,P0300,P0300,P0300,P0300,P0300,P0200,M0300,M0300,M0300,P0200,P0300,P0300,P0300,P0300,P0300,M0202,P0300,P0300,P0300
P0300,P0300,P0300,P0300,P0300,P0300,P0300,P0300,P0300,P0200,M0300,M0300,M0300,P0200,P0300,P0300,P0300,P0300,P0300,P0300,P0300,P0300,P0300