P0100,P0100,P0100,P0100,P0100,P0100,P0100,P0100,P0100,P0100,P0100,P0100,P0100,P0100,P0100,P0100,P0100,P0100,P0100,P0100,P0100,P0100,P0100,P0100,P0100,P0100,P0100,P0100,P0100,P0100,P0100,P0100,P0100,P0100,P0100,P0100,P0100,P0100,P0100,P0100,P0100,P0100,P0100,P0100,P0100,P0100,P0100,P0100,P0100,P0100,P0100,P0100,P0100,P0100,P0100,P0100,P0100,P0100,P0100,P0100
P0100,P0100,P0100,P0100,P0100,P0100,P0100,P0100,P0100,P0100,P0100,P0100,P0100,P0100,P0100,P0100,P0100,P0100,P0100,P0100,P0100,P0100,P0100,P0100,P0100,P0100,P0100,P0100,P0100,P0100,P0100,P0100,P0100,P0100,P0100,P0100,P0100,P0100,P0100,P0100,P0100,P0100,P0100,P0100,P0100,P0100,P0100,P0100,P0100,P0100,P0100,P0100,P0100,P0100,P0100,P0100,P0100,P0100,P0100,P0100
P0100,P0100,P0100,P0100,P0100,P0100,P0100,P0100,P0100,P0100,P0100,P0100,P0100,P0100,P0100,P0100,P0100,P0100,P0100,P0100,P0100,P0100,P0100,P0100,P0100,P0100,P0100,P0100,P0100,P0100,P0100,P0100,P0100,P0100,P0100,P0100,P0100,P0100,P0100,P0100,P0100,P0100,P0100,P0100,P0100,P0100,P0100,P0100,P0100,P0100,P0100,P0100,P0100,P0100,P0100,P0100,P0100,P0100,P0100,P0100
P0100,P0100,P0100,P0100,P0100,P0100,P0100,P0100,P0100,P0100,P0100,P0100,P0100,P0100,P0100,P0100,P0100,P0100,P0100,P0100,P0100,P0100,P0100,P0100,P0100,P0100,P0100,P0100,P0100,P0100,P0100,P0100,P0100,P0100,P0100,P0100,P0100,P0100,P0100,P0100,P0100,P0100,P0100,P0100,P0100,P0100,P0100,P0100,P0100,P0100,P0100,P0100,P0100,P0100,P0100,P0100,P0100,P0100,P0100,P0100
P0100,P0100,P0100,P0100,P0100,P0100,P0100,P0100,P0100,P0100,P0100,P0100,P0100,P0100,P0100,P0100,P0100,P0100,P0100,P0100,P0100,P0100,P0100,P0100,P0100,P0100,P0100,P0100,P0100,P0100,P0100,P0100,P0100,P0100,P0100,P0100,P0100,P0100,P0100,P0100,P0100,P0100,P0100,P0100,P0100,P0100,P0100,P0100,P0100,P0100,P0100,P0100,P0100,P0100,P0100,P0100,P0100,P0100,P0100,P0100
P0100,P0100,P0100,P0100,P0100,P0100,P0100,P0100,P0100,P0100,P0100,P0100,P0100,P0100,P0100,P0100,P0100,P0100,P0100,P0100,P0100,P0100,P0100,P0100,P0100,P0100,P0100,P0100,P0100,P0100,P0100,P0100,P0100,P0100,P0100,P0100,P0100,P0100,P0100,P0100,P0100,P0100,P0100,P0100,P0100,P0100,P0100,P0100,P0100,P0100,P0100,P0100,P0100,P0100,P0100,P0100,P0100,P0100,P0100,P0100
P0100,P0100,P0100,P0100,P0100,P0100,P0100,P0100,P0100,P0100,P0100,P0100,P0100,P0100,P0100,P0100,P0100,P0100,P0100,P0100,P0100,P0100,P0100,P0100,P0100,P0100,P0100,P0100,P0100,P0100,P0100,P0100,P0100,P0100,P0100,P0100,P0100,P0100,P0100,P0100,P0100,P0100,P0100,P0100,P0100,P0100,P0100,P0100,P0100,P0100,P0100,P0100,P0100,P0100,P0100,P0100,P0100,P0100,P0100,P0100
P0100,P0100,P0100,P0100,P0100,P0100,P0100,P0100,P0100,P0100,P0100,P0100,P0100,P0100,P0100,P0100,P0100,P0100,P0100,P0100,P0100,P0100,P0100,P0100,P0100,P0100,P0100,P0100,P0100,P0100,P0100,P0100,P0100,P0100,P0100,P0100,P0100,P0100,P0100,P0100,P0100,P0100,P0100,P0100,P0100,P0100,P0100,P0100,P0100,P0100,P0100,P0100,P0100,P0100,P0100,P0100,P0100,P0100,P0100,P0100
P0100,P0100,P0100,P0100,P0100,P0100,P0100,P0100,P0100,P0100,P0100,P0100,P0100,P0100,P0100,P0100,P0100,P0100,P0100,P0100,P0100,P0100,P0100,P0100,P0100,P0100,P0100,P0100,P0100,P0100,P0100,P0100,P0100,P0100,P0100,P0100,P0100,P0100,P0100,P0100,P0100,P0100,P0100,P0100,P0100,P0100,P0100,P0100,P0100,P0100,P0100,P0100,P0100,P0100,P0100,P0100,P0100,P0100,P0100,P0100
P0100,P0100,P0100,P0100,P0100,P0100,P0100,P0100,P0100,P0100,P0100,P0100,P0100,P0100,P0100,P0100,P0100,P0100,P0100,P0100,P0100,P0100,P0100,P0100,P0100,P0100,P0100,P0100,P0100,P0100,P0100,P0100,P0100,P0100,P0100,P0100,P0100,P0100,P0100,P0100,P0100,P0100,P0100,P0100,P0100,P0100,P0100,P0100,P0100,P0100,P0100,P0100,P0100,P0100,P0100,P0100,P0100,P0100,P0100,P0100
P0100,P0100,P0100,P0100,P0100,P0100,P0100,P0100,P0100,P0100,P0100,P0100,P0100,P0100,P0100,P0100,P0100,P0100,P0100,P0100,P0100,P0100,P0100,P0100,P0100,P0100,P0100,P0100,P0100,P0100,P0100,P0100,P0100,P0100,P0100,P0100,P0100,P0100,P0100,P0100,P0100,P0100,P0100,P0100,P0100,P0100,P0100,P0100,P0100,P0100,P0100,P0100,P0100,P0100,P0100,P0100,P0100,P0100,P0100,P0100
P0100,P0100,P0100,P0100,P0100,P0100,P0100,P0100,P0100,P0100,P0100,P0100,P0100,P0100,P0100,P0100,P0100,P0100,P0100,P0100,P0100,P0100,P0100,P0100,P0100,P0100,P0100,P0100,P0100,P0100,P0100,P0100,P0100,P0100,P0100,P0100,P0100,P0100,P0100,P0100,P0100,P0100,P0100,P0100,P0100,P0100,P0100,P0100,P0100,P0100,P0100,P0100,P0100,P0100,P0100,P0100,P0100,P0100,P0100,P0100
P0100,P0100,P0100,P0100,P0100,P0100,P0100,P0100,P0100,P0100,P0100,P0100,P0100,P0100,N0300,N0300,P0100,P0100,P0100,P0100,P0100,P0100,P0100,P0100,P0100,P0100,P0100,P0100,P0100,P0100,P0100,P0100,P0100,P0100,P0100,P0100,P0100,P0100,P0100,P0100,W0100,W0100,W0100,P0100,P0100,P0100,P0100,P0100,P0100,P0100,P0100,P0100,P0100,P0100,P0100,P0100,P0100,P0100,P0100,P0100
P0100,P0100,P0100,P0100,P0100,P0100,P0100,P0100,P0100,P0100,P0100,P0100,P0100,P0100,N0300,N0300,P0100,P0100,P0100,P0100,P0100,P0100,P0100,P0100,P0100,P0100,P0100,P0100,P0100,P0100,P0100,P0100,P0100,P0100,P0100,P0100,P0100,P0100,W0100,W0100,W0100,W0100,W0100,W0100,W0100,P0100,P0100,P0100,P0100,P0100,P0100,P0100,P0100,P0100,P0100,P0100,P0100,P0100,P0100,P0100
P0100,P0100,P0100,P0100,P0100,P0100,P0100,P0100,P0100,P0100,P0100,P0100,N0300,N0300,N0300,N0300,N0300,P0100,P0100,P0100,P0100,P0100,P0100,P0100,P0100,P0100,P0100,P0100,P0100,P0100,P0100,P0100,P0100,P0100,P0100,P0100,P0100,P0100,P0100,P0100,P0100,W0100,W0100,W0100,P0100,P0100,P0100,P0100,P0100,P0100,P0100,P0100,P0100,P0100,P0100,P0100,P0100,P0100,P0100,P0100
P0100,P0100,P0100,P0100,P0100,P0100,P0100,P0100,P0100,P0100,P0100,P0100,P0100,N0300,N0300,N0300,N0300,P0100,P0100,P0100,P0100,P0100,P0100,P0100,P0100,P0100,P0100,P0100,P0100,P0100,P0100,P0100,P0100,P0100,P0100,P0100,P0100,P0100,P0100,P0100,P0100,P0100,P0100,P0100,P0100,P0100,P0100,P0100,P0100,P0100,P0100,P0100,P0100,P0100,P0100,P0100,P0100,P0100,P0100,P0100
P0100,P0100,P0100,P0100,P0100,P0100,P0100,P0100,P0100,P0100,P0100,N0400,P0100,N0300,N0300,N0300,N0300,N0300,N0300,N0300,P0100,P0100,P0100,P0100,P0100,P0100,P0100,P0100,P0100,P0100,P0100,P0100,P0100,P0100,P0100,P0100,P0100,P0100,P0100,P0100,P0100,P0100,P0100,P0100,W0100,P0100,P0100,P0100,P0100,P0100,P0100,P0100,P0100,P0100,P0100,P0100,P0100,P0100,P0100,P0100
P0100,P0100,P0100,P0100,P0100,P0100,P0100,P0100,P0100,P0100,P0100,P0100,P0100,P0100,P0100,P0100,P0100,P0100,P0100,P0100,P0100,P0100,P0100,P0100,P0100,P0100,P0100,P0100,P0100,P0100,P0100,P0100,P0100,P0100,P0100,P0100,P0100,P0100,P0100,P0100,P0100,P0100,P0100,P0100,P0100,P0100,P0100,P0100,P0100,P0100,P0100,P0100,P0100,P0100,P0100,P0100,P0100,P0100,P0100,P0100
P0100,P0100,P0100,P0100,P0100,P0100,P0100,P0100,P0100,P0100,P0100,P0100,P0100,P0100,N0400,N0400,P0100,P0100,P0100,P0100,P0100,P0100,P0100,P0100,P0100,P0100,N0300,N0300,N0300,N0300,N0300,N0300,P0100,P0100,P0100,P0100,P0100,P0100,P0100,P0100,P0100,P0100,P0100,P0100,P0100,P0100,W0100,P0100,P0100,P0100,P0100,P0100,P0100,P0100,P0100,P0100,P0100,P0100,P0100,P0100
P0100,P0100,P0100,P0100,P0100,P0100,P0100,P0100,P0100,P0100,P0100,P0100,P0100,P0100,P0100,P0100,P0100,P0100,P0100,P0100,P0100,P0100,P0100,P0100,P0100,P0100,N0300,N0300,N0300,N0300,N0300,N0300,P0100,P0100,P0100,P0100,P0100,P0100,P0100,P0100,P0100,P0100,P0100,P0100,P0100,P0100,W0100,P0100,P0100,P0100,P0100,P0100,P0100,P0100,P0100,P0100,P0100,P0100,P0100,P0100
P0100,P0100,P0100,P0100,P0100,P0100,P0100,P0100,P0100,P0100,P0100,P0100,P0100,P0100,P0100,P0100,P0100,P0100,P0100,P0100,P0100,P0100,P0100,N0300,N0300,N0300,N0300,N0300,N0300,N0300,N0300,N0300,N0300,P0100,P0100,P0100,P0100,P0100,P0100,P0100,P0100,P0100,P0100,P0100,P0100,P0100,P0100,P0100,P0100,P0100,P0100,P0100,P0100,P0100,P0100,P0100,P0100,P0100,P0100,P0100
P0100,P0100,P0100,P0100,P0100,P0100,P0100,P0100,P0100,P0100,P0100,P0100,P0100,P0100,P0100,P0100,P0100,P0100,P0100,P0100,P0100,P0100,P0100,N0300,N0300,N0300,N0300,N0300,N0300,N0300,N0300,N0300,N0300,P0100,P0100,P0100,P0100,P0100,P0100,P0100,P0100,P0100,P0100,P0100,P0100,P0100,P0100,P0100,P0100,P0100,P0100,P0100,P0100,P0100,P0100,P0100,P0100,P0100,P0100,P0100
P0100,P0100,P0100,P0100,P0100,P0100,P0100,P0100,P0100,P0100,P0100,P0100,P0100,P0100,P0100,P0100,P0100,P0100,P0100,P0100,P0100,P0100,P0100,N0300,N0300,N0300,N0300,N0300,N0300,N0300,N0300,N0300,N0300,P0100,P0100,P0100,P0100,P0100,P0100,P0100,P0100,P0100,P0100,P0100,P0100,P0100,P0100,P0100,P0100,P0100,P0100,P0100,P0100,P0100,P0100,P0100,P0100,P0100,P0100,P0100
P0100,P0100,P0100,N0300,N0300,P0100,P0100,P0100,P0100,P0100,P0100,P0100,P0100,P0100,P0100,P0100,P0100,P0100,P0100,P0100,P0100,P0100,P0100,N0300,N0300,N0300,N0300,N0300,N0300,N0300,N0300,N0300,N0300,P0100,P0100,P0100,P0100,P0100,P0100,P0100,N0300,N0300,P0100,P0100,P0100,P0100,P0100,P0100,P0100,P0100,P0100,P0100,P0100,P0100,P0100,P0100,P0100,P0100,P0100,P0100
P0100,P0100,P0100,N0300,N0300,P0100,P0100,P0100,P0100,P0100,P0100,P0100,P0100,P0100,P0100,P0100,P0100,P0100,P0100,P0100,P0100,P0100,P0100,N0300,N0300,N0300,N0300,N0300,N0300,N0300,N0300,N0300,N0300,N0300,P0100,P0100,P0100,P0100,P0100,P0100,P0100,N0300,P0100,P0100,P0100,P0100,P0100,P0100,P0100,P0100,P0100,P0100,P0100,P0100,P0100,P0100,P0100,P0100,P0100,P0100
P0100,P0100,P0100,N0300,N0300,P0100,P0100,P0100,P0100,P0100,P0100,P0100,P0100,P0100,P0100,P0100,P0100,P0100,P0100,P0100,P0100,P0100,P0100,N0300,N0300,N0300,N0300,N0300,N0300,N0300,N0300,N0300,N0300,N0300,P0100,P0100,P0100,P0100,P0100,N0300,N0300,N0300,N0300,P0100,P0100,P0100,P0100,P0100,P0100,P0100,P0100,P0100,P0100,P0100,P0100,P0100,P0100,P0100,P0100,P0100
P0100,P0100,P0100,N0300,N0300,P0100,N0400,P0100,P0100,P0100,P0100,P0100,P0100,P0100,P0100,P0100,P0100,P0100,P0100,P0100,P0100,P0100,N0300,N0300,N0300,N0300,N0300,N0300,N0300,N0300,N0300,N0300,N0300,N0300,N0400,P0100,P0100,P0100,P0100,P0100,P0100,P0100,P0100,P0100,P0100,P0100,P0100,P0100,P0100,P0100,P0100,P0100,P0100,P0100,P0100,P0100,P0100,P0100,P0100,P0100
P0100,P0100,P0100,P0100,P0100,P0100,N0300,P0100,P0100,P0100,P0100,P0100,P0100,P0100,P0100,P0100,P0100,P0100,P0100,P0100,P0100,P0100,N0300,N0300,N0300,N0300,N0300,N0300,N0300,N0300,N0300,N0300,N0300,N0300,N0400,P0100,P0100,P0100,P0100,P0100,P0100,P0100,P0100,P0100,P0100,P0100,P0100,P0100,P0100,P0100,P0100,P0100,P0100,P0100,P0100,P0100,P0100,P0100,P0100,P0100
P0100,P0100,P0100,P0100,P0100,P0100,N0300,P0100,P0100,P0100,P0100,P0100,P0100,P0100,P0100,P0100,P0100,P0100,P0100,P0100,P0100,P0100,N0400,N0300,N0300,N0300,N0300,N0300,N0300,N0300,N0300,N0300,N0300,N0300,N0400,N0400,P0100,P0100,P0100,P0100,P0100,P0100,P0100,P0100,P0100,P0100,P0100,P0100,P0100,P0100,P0100,P0100,P0100,P0100,P0100,P0100,P0100,P0100,P0100,P0100
P0100,P0100,P0100,P0100,P0100,P0100,P0100,P0100,P0100,P0100,P0100,P0100,P0100,P0100,P0100,P0100,P0100,P0100,P0100,P0100,N0400,N0400,N0400,N0400,N0300,N0300,N0300,N0300,N0300,N0300,N0300,N0300,N0300,N0300,N0300,N0400,N0400,N0400,N0300,P0100,P0100,P0100,P0100,P0100,P0100,P0100,P0100,P0100,P0100,P0100,P0100,P0100,P0100,P0100,P0100,P0100,P0100,P0100,P0100,P0100
P0100,P0100,P0100,P0100,P0100,P0100,P0100,P0100,P0100,P0100,P0100,P0100,P0100,P0100,P0100,P0100,P0100,P0100,P0100,P0100,P0100,P0100,P0100,P0100,N0400,N0400,N0300,N0300,N0300,N0300,N0300,N0300,N0300,N0300,N0300,N0300,N0400,P0100,N0400,P0100,P0100,P0100,P0100,P0100,P0100,P0100,P0100,P0100,P0100,P0100,P0100,P0100,P0100,P0100,P0100,P0100,P0100,P0100,P0100,P0100
P0100,P0100,P0100,P0100,P0100,P0100,P0100,P0100,P0100,P0100,P0100,P0100,P0100,P0100,P0100,P0100,P0100,P0100,P0100,P0100,P0100,P0100,P0100,P0100,P0100,P0100,P0100,P0100,N0300,N0300,N0300,N0300,N0300,N0300,N0300,N0300,N0300,P0100,P0100,N0400,P0100,P0100,P0100,P0100,P0100,P0100,P0100,P0100,P0100,P0100,P0100,P0100,P0100,P0100,P0100,P0100,P0100,P0100,P0100,P0100
P0100,P0100,P0100,P0100,P0100,P0100,P0100,P0100,P0100,P0100,P0100,P0100,P0100,P0100,P0100,P0100,P0100,P0100,P0100,P0100,P0100,P0100,P0100,P0100,P0100,P0100,P0100,P0100,P0100,N0300,N0300,N0300,N0300,N0300,N0300,N0300,N0300,P0100,P0100,P0100,P0100,P0100,P0100,P0100,P0100,P0100,P0100,P0100,P0100,P0100,P0100,P0100,P0100,P0100,P0100,P0100,P0100,P0100,P0100,P0100
P0100,P0100,P0100,P0100,P0100,P0100,P0100,P0100,P0100,P0100,P0100,P0100,P0100,P0100,P0100,P0100,P0100,P0100,P0100,P0100,P0100,P0100,P0100,P0100,P0100,P0100,P0100,P0100,P0100,N0300,N0300,N0300,N0300,P0100,P0100,P0100,P0100,P0100,P0100,P0100,P0100,P0100,P0100,P0100,P0100,P0100,P0100,P0100,P0100,P0100,P0100,P0100,P0100,P0100,P0100,P0100,P0100,P0100,P0100,P0100
P0100,P0100,P0100,P0100,P0100,P0100,P0100,P0100,P0100,P0100,P0100,P0100,P0100,P0100,P0100,P0100,P0100,P0100,P0100,P0100,P0100,P0100,P0100,N0300,N0300,N0300,N0300,P0100,P0100,P0100,P0100,P0100,P0100,P0100,P0100,P0100,P0100,P0100,P0100,N0400,P0100,P0100,P0100,P0100,P0100,P0100,P0100,P0100,P0100,P0100,P0100,P0100,P0100,P0100,P0100,P0100,P0100,P0100,P0100,P0100
P0100,P0100,P0100,P0100,P0100,P0100,P0100,P0100,P0100,P0100,P0100,P0100,P0100,P0100,P0100,P0100,P0100,P0100,P0100,P0100,P0100,P0100,P0100,N0300,N0300,N0300,N0300,N0300,N0300,P0100,N0300,N0300,N0300,N0300,P0100,P0100,P0100,P0100,P0100,N0400,P0100,P0100,P0100,P0100,P0100,P0100,P0100,P0100,P0100,P0100,P0100,P0100,P0100,P0100,P0100,P0100,P0100,P0100,P0100,P0100
P0100,P0100,P0100,P0100,P0100,P0100,P0100,P0100,P0100,P0100,P0100,P0100,P0100,P0100,P0100,P0100,P0100,P0100,P0100,P0100,P0100,P0100,P0100,P0100,P0100,P0100,P0100,N0300,N0300,N0300,N0300,N0300,N0300,N0300,P0100,P0100,P0100,P0100,P0100,P0100,P0100,P0100,P0100,P0100,P0100,P0100,P0100,P0100,P0100,P0100,P0100,P0100,P0100,P0100,P0100,P0100,P0100,P0100,P0100,P0100
P0100,P0100,P0100,P0100,P0100,P0100,P0100,P0100,P0100,P0100,P0100,P0100,P0100,N0400,P0100,P0100,P0100,P0100,P0100,P0100,P0100,P0100,P0100,P0100,P0100,P0100,P0100,P0100,N0300,N0300,N0300,N0300,N0300,N0300,N0300,N0300,P0100,P0100,P0100,P0100,P0100,P0100,P0100,P0100,P0100,P0100,P0100,P0100,P0100,P0100,P0100,P0100,P0100,P0100,P0100,P0100,P0100,P0100,P0100,N0400P
P0100,P0100,P0100,P0100,P0100,P0100,P0100,P0100,P0100,P0100,P0100,P0100,N0400,N0400,P0100,P0100,P0100,P0100,P0100,P0100,P0100,P0100,P0100,P0100,P0100,P0100,P0100,P0100,N0300,N0300,N0300,N0300,N0300,N0300,N0300,N0300,P0100,P0100,P0100,P0100,P0100,P0100,P0100,P0100,P0100,P0100,P0100,P0100,P0100,P0100,P0100,P0100,P0100,P0100,P0100,P0100,P0100,P0100,P0100,N0400P
P0100,P0100,P0100,P0100,P0100,P0100,P0100,P0100,P0100,P0100,P0100,P0100,N0400,N0400,P0100,P0100,P0100,P0100,P0100,P0100,P0100,P0100,N0300,P0100,P0100,P0100,P0100,P0100,P0100,P0100,P0100,P0100,N0300,N0300,N0300,N0300,P0100,P0100,P0100,P0100,P0100,P0100,P0100,P0100,P0100,P0100,P0100,P0100,P0100,P0100,P0100,P0100,P0100,P0100,P0100,P0100,P0100,P0100,P0100,N0400P
P0100,P0100,P0100,P0100,P0100,P0100,P0100,P0100,P0100,P0100,P0100,N0400,N0400,N0400,P0100,P0100,P0100,P0100,P0100,P0100,P0100,P0100,N0300,P0100,P0100,P0100,P0100,P0100,P0100,P0100,P0100,P0100,N0300,N0300,N0300,N0300,P0100,P0100,P0100,P0100,P0100,P0100,P0100,P0100,P0100,P0100,P0100,P0100,P0100,P0100,P0100,P0100,P0100,P0100,P0100,P0100,P0100,P0100,N0400P,N0400P
P0100,P0100,P0100,P0100,P0100,P0100,P0100,P0100,P0100,P0100,P0100,N0400,N0400,N0400,P0100,P0100,P0100,P0100,P0100,P0100,P0100,P0100,P0100,P0100,P0100,N0300,N0300,N0300,N0300,P0100,P0100,P0100,P0100,P0100,P0100,P0100,P0100,P0100,P0100,P0100,P0100,P0100,P0100,P0100,P0100,P0100,P0100,P0100,P0100,P0100,P0100,P0100,P0100,P0100,P0100,P0100,P0100,P0100,N0400P,N0400P
P0100,P0100,P0100,P0100,P0100,P0100,P0100,P0100,P0100,P0100,P0100,N0400,N0400,N0400,P0100,N0400,N0400,P0100,P0100,P0100,P0100,P0100,P0100,P0100,P0100,N0300,N0300,N0300,N0300,N0300,P0100,P0100,P0100,P0100,P0100,P0100,P0100,P0100,P0100,P0100,P0100,P0100,P0100,P0100,P0100,P0100,P0100,P0100,P0100,P0100,P0100,P0100,P0100,P0100,P0100,P0100,P0100,P0100,N0400P,N0400P
P0100,P0100,P0100,P0100,P0100,P0100,P0100,P0100,P0100,P0100,P0100,N0400,N0400,N0300,P0100,N0400,N0400,P0100,P0100,P0100,P0100,P0100,P0100,P0100,P0100,N0300,N0300,N0300,N0300,N0300,P0100,N0300,P0100,P0100,P0100,P0100,P0100,P0100,P0100,P0100,P0100,P0100,P0100,P0100,P0100,P0100,P0100,P0100,P0100,P0100,P0100,P0100,P0100,P0100,P0100,P0100,P0100,N0400P,N0400P,N0400P
P0100,P0100,P0100,P0100,P0100,P0100,P0100,P0100,P0100,P0100,P0100,N0400,N0400,N0300,P0100,P0100,W0100,W0100,P0100,P0100,P0100,P0100,P0100,P0100,P0100,N0300,N0300,N0300,N0300,P0100,P0100,N0300,P0100,P0100,P0100,P0100,P0100,P0100,P0100,P0100,P0100,P0100,P0100,P0100,P0100,P0100,P0100,P0100,P0100,P0100,P0100,P0100,P0100,P0100,P0100,P0100,P0100,N0400P,N0400P,N0400P
P0100,P0100,P0100,P0100,P0100,P0100,P0100,P0100,P0100,N0400,N0400,N0400,N0300,N0300,N0300,W0100,W0100,W0100,P0100,W0100,W0100,P0100,P0100,P0100,P0100,P0100,P0100,P0100,P0100,P0100,P0100,P0100,P0100,P0100,P0100,P0100,P0100,P0100,P0100,P0100,P0100,P0100,P0100,P0100,P0100,P0100,P0100,P0100,P0100,P0100,P0100,P0100,P0100,P0100,P0100,P0100,P0100,N0400P,N0400P,N0400P
P0100,P0100,P0100,P0100,P0100,P0100,P0100,P0100,P0100,P0100,N0400,N0400,N0300,N0300,P0100,W0100,W0100,W0100,P0100,P0100,P0100,P0100,P0100,P0100,P0100,P0100,P0100,P0100,P0100,P0100,P0100,P0100,P0100,P0100,P0100,P0100,P0100,P0100,P0100,P0100,P0100,P0100,P0100,P0100,P0100,P0100,P0100,P0100,P0100,P0100,P0100,P0100,P0100,P0100,P0100,P0100,N0400P,N0400P,N0400P,N0400P
P0100,P0100,P0100,P0100,P0100,P0100,P0100,P0100,P0100,P0100,N0400,N0400,N0400,N0300,P0100,P0100,W0100,P0100,P0100,P0100,P0100,P0100,P0100,P0100,P0100,P0100,P0100,P0100,P0100,P0100,P0100,P0100,P0100,P0100,P0100,P0100,P0100,P0100,P0100,P0100,P0100,P0100,P0100,P0100,P0100,P0100,P0100,P0100,P0100,P0100,P0100,P0100,P0100,P0100,P0100,P0100,N0400P,N0400P,N0400P,N0400P
P0100,P0100,P0100,P0100,P0100,P0100,P0100,P0100,P0100,P0100,P0100,N0400,N0400,N0400,N0400,N0400,N0400,N0400,N0400,N0400,P0100,P0100,P0100,P0100,P0100,P0100,P0100,P0100,P0100,P0100,P0100,P0100,P0100,P0100,P0100,P0100,P0100,P0100,P0100,P0100,P0100,P0100,P0100,P0100,P0100,P0100,P0100,P0100,P0100,P0100,P0100,P0100,P0100,P0100,P0100,N0400P,N0400P,N0400P,N0400P,N0400P
P0100,P0100,P0100,P0100,P0100,P0100,P0100,P0100,P0100,P0100,P0100,N0400,N0400,N0400,N0400,N0400,N0400,N0400,N0400,N0400,P0100,P0100,P0100,P0100,P0100,P0100,P0100,P0100,P0100,P0100,P0100,P0100,P0100,P0100,P0100,P0100,P0100,P0100,P0100,P0100,P0100,P0100,P0100,P0100,P0100,P0100,P0100,P0100,P0100,P0100,P0100,P0100,P0100,P0100,P0100,N0400P,N0400P,N0400P,N0400P,N0400P
P0100,P0100,P0100,P0100,P0100,P0100,P0100,P0100,P0100,P0100,P0100,N0400,N0400,N0400,P0100,P0100,P0100,P0100,P0100,P0100,P0100,P0100,P0100,P0100,P0100,P0100,P0100,P0100,P0100,P0100,P0100,P0100,P0100,P0100,P0100,P0100,P0100,P0100,P0100,P0100,P0100,P0100,P0100,P0100,P0100,P0100,P0100,P0100,P0100,P0100,P0100,P0100,P0100,P0100,N0400P,N0400P,N0400P,N0400P,N0400P,N0400P
P0100,P0100,P0100,P0100,P0100,P0100,P0100,P0100,P0100,P0100,P0100,P0100,N0400,N0400,P0100,P0100,P0100,P0100,P0100,P0100,P0100,P0100,P0100,P0100,P0100,P0100,P0100,P0100,P0100,P0100,P0100,P0100,P0100,P0100,P0100,P0100,P0100,P0100,P0100,P0100,P0100,P0100,P0100,P0100,P0100,P0100,P0100,P0100,P0100,P0100,P0100,P0100,P0100,N0400P,N0400P,N0400P,N0400P,N0400P,N0400P,N0400P
P0100,P0100,P0100,P0100,P0100,P0100,P0100,P0100,P0100,P0100,P0100,P0100,P0100,N0400,P0100,P0100,P0100,P0100,P0100,P0100,P0100,P0100,P0100,P0100,P0100,P0100,P0100,P0100,P0100,P0100,P0100,P0100,P0100,P0100,P0100,P0100,P0100,P0100,P0100,P0100,P0100,P0100,P0100,P0100,P0100,P0100,P0100,P0100,P0100,P0100,P0100,N0400P,N0400P,N0400P,N0400P,N0400P,N0400P,N0400P,N0400P,N0400P
P0100,P0100,P0100,P0100,P0100,P0100,P0100,P0100,P0100,P0100,P0100,P0100,P0100,P0100,P0100,P0100,P0100,P0100,P0100,P0100,P0100,P0100,P0100,P0100,P0100,P0100,P0100,P0100,P0100,P0100,P0100,P0100,P0100,P0100,P0100,P0100,P0100,P0100,P0100,P0100,P0100,P0100,P0100,P0100,P0100,P0100,P0100,P0100,P0100,N0400P,N0400P,N0400P,N0400P,N0400P,N0400P,N0400P,N0400P,N0400P,N0400P,N0400P
P0100,P0100,P0100,P0100,P0100,P0100,P0100,P0100,P0100,P0100,P0100,P0100,P0100,P0100,P0100,P0100,P0100,P0100,P0100,P0100,P0100,P0100,P0100,P0100,P0100,P0100,P0100,P0100,P0100,P0100,P0100,P0100,P0100,P0100,P0100,P0100,P0100,P0100,P0100,P0100,P0100,P0100,P0100,P0100,P0100,P0100,P0100,N0400P,N0400P,N0400P,N0400P,N0400P,N0400P,N0400P,N0400P,N0400P,N0400P,N0400P,N0400P,N0400P
P0100,P0100,P0100,P0100,P0100,P0100,P0100,P0100,P0100,P0100,P0100,P0100,P0100,P0100,P0100,P0100,P0100,P0100,P0100,P0100,P0100,P0100,P0100,P0100,P0100,P0100,P0100,P0100,P0100,P0100,P0100,P0100,P0100,P0100,P0100,P0100,P0100,P0100,P0100,P0100,P0100,P0100,P0100,P0100,N0400P,N0400P,N0400P,N0400P,N0400P,N0400P,N0400P,N0400P,N0400P,N0400P,N0400P,N0400P,N0400P,N0400P,N0400P,N0400P
P0100,P0100,P0100,P0100,P0100,P0100,P0100,P0100,P0100,P0100,P0100,P0100,P0100,P0100,P0100,P0100,P0100,P0100,P0100,P0100,P0100,P0100,P0100,P0100,P0100,P0100,P0100,P0100,P0100,P0100,P0100,P0100,P0100,P0100,P0100,P0100,P0100,P0100,P0100,P0100,P0100,N0400P,N0400P,N0400P,N0400P,N0400P,N0400P,N0400P,N0400P,N0400P,N0400P,N0400P,N0400P,N0400P,N0400P,N0400P,N0400P,N0400P,N0400P,N0400P
P0100,P0100,P0100,P0100,P0100,P0100,P0100,P0100,P0100,P0100,P0100,P0100,P0100,P0100,P0100,P0100,P0100,P0100,P0100,P0100,P0100,P0100,P0100,P0100,P0100,P0100,P0100,P0100,P0100,P0100,P0100,P0100,P0100,P0100,P0100,P0100,P0100,P0100,N0400P,N0400P,N0400P,N0400P,N0400P,N0400P,N0400P,N0400P,N0400P,N0400P,N0400P,N0400P,N0400P,N0400P,N0400P,N0400P,N0400P,N0400P,N0400P,N0400P,N0400P,N0400P
P0100,P0100,P0100,P0100,P0100,P0100,P0100,P0100,P0100,P0100,P0100,P0100,P0100,P0100,P0100,P0100,P0100,P0100,P0100,P0100,P0100,P0100,P0100,P0100,P0100,P0100,P0100,P0100,P0100,P0100,P0100,P0100,P0100,P0100,P0100,N0400P,N0400P,N0400P,N0400P,N0400P,N0400P,N0400P,N0400P,N0400P,N0400P,N0400P,N0400P,N0400P,N0400P,N0400P,N0400P,N0400P,N0400P,N0400P,N0400P,N0400P,N0400P,N0400P,N0400P,N0400P
P0100,P0100,P0100,P0100,P0100,P0100,P0100,P0100,P0100,P0100,P0100,P0100,P0100,P0100,P0100,P0100,P0100,P0100,P0100,P0100,P0100,P0100,P0100,P0100,P0100,P0100,P0100,P0100,P0100,P0100,P0100,P0100,N0400P,N0400P,N0400P,N0400P,N0400P,N0400P,N0400P,N0400P,N0400P,N0400P,N0400P,N0400P,N0400P,N0400P,N0400P,N0400P,N0400P,N0400P,N0400P,N0400P,N0400P,N0400P,N0400P,N0400P,N0400P,N0400P,N0400P,N0400P