P0300,P0301,P0301,P0302,P0302,P0301,P0301,P0300,P0300
P0300,P0300,P0300,P0301,P0301,P0300,P0300,P0300,P0300
P0300,P0300,P0300,-,-,P0300,P0300,P0300,P0300
P0300,P0300,P0300,P0300,P0300,P0300,P0300,P0300,P0300
P0300,P0300,P0300,P0300,P0300,P0300,P0300,P0300,P0300
P0300,P0300,P0300,P0300,P0300,P0300,P0300,P0300,P0300
P0300,P0300,P0300,P0300,P0300,P0300,P0300,P0300,P0300
P0300,P0300,P0300,P0300,P0300,P0300,P0300,P0300,P0300
P0300,P0300,P0300,P0300,P0300,P0300,P0300,P0300,P0300
P0300,P0300,P0300,P0300,P0300,P0300,P0300,P0300,P0300