N0403,N0403,N0403,N0403,N0403,N0403,N0403,N0400,N0403,N0400,N0403,N0403,N0403,N0403,N0403,N0403,N0403
N0403,N0400,N0400,N0400,N0400,N0400,N0400,N0400,N0400,N0400,N0400,N0400,N0400,N0400,N0400,N0400,N0403
N0403,N0400,N0403,N0403,N0403,N0403,N0403,N0403,N0400,N0403,N0403,N0403,N0403,N0403,N0403,N0400,N0403
N0403,N0400,N0400,N0400,N0400,N0400,N0403,N0403,N0400,N0403,N0403,N0400,N0400,N0400,N0400,N0400,N0403
N0403,N0400,N0403,N0403,N0403,N0400,N0403,N0400,N0400,N0400,N0403,N0400,N0403,N0403,N0403,N0400,N0403
N0403,N0400,N0400,N0400,N0400,N0400,N0400,N0400,N0400,N0400,N0400,N0400,N0400,N0400,N0400,N0400,N0403
N0403,N0400,N0403,N0403,N0400,N0400,N0400,N0400,N0400,N0400,N0400,N0400,N0400,N0403,N0403,N0400,N0403
N0403,N0400,N0400,N0400,N0400,N0400,N0400,N0400,N0400,N0400,N0400,N0400,N0400,N0400,N0400,N0400,N0403
N0403,N0400,N0403,N0400,N0400,N0400,N0400,N0400,N0400,N0400,N0400,N0400,N0400,N0400,N0403,N0400,N0403
N0403,N0400,N0400,N0400,N0400,N0400,N0400,N0400,N0400,N0400,N0400,N0400,N0400,N0400,N0400,N0400,N0403
N0403,N0400,N0403,N0400,N0400,N0400,N0400,N0400,N0400,N0400,N0400,N0400,N0400,N0400,N0403,N0400,N0403
N0403,N0400,N0400,N0400,N0400,N0400,N0400,N0400,N0400,N0400,N0400,N0400,N0400,N0400,N0400,N0400,N0403
N0403,N0400,N0403,N0400,N0400,N0400,N0400,N0400,N0400,N0400,N0400,N0400,N0400,N0400,N0403,N0400,N0403
N0403,N0400,N0403,N0400,N0400,N0400,N0400,N0400,N0400,N0400,N0400,N0400,N0400,N0400,N0403,N0400,N0403
N0403,N0400,N0403,N0400,N0400,N0400,N0400,N0400,N0400,N0400,N0400,N0400,N0400,N0400,N0403,N0400,N0403
N0403,N0400,N0403,N0400,N0400,N0400,N0400,N0400,N0400,N0400,N0400,N0400,N0400,N0400,N0403,N0400,N0403
N0403,N0400,N0403,N0400,N0400,N0400,N0400,N0400,N0400,N0400,N0400,N0400,N0400,N0400,N0403,N0400,N0403
N0403,N0400,N0403,N0400,N0400,N0400,N0400,N0400,N0400,N0400,N0400,N0400,N0400,N0400,N0403,N0400,N0403