M0200,M0200,M0200,M0201,M0200,M0202,M0202,M0200,M0200,M0200,M0201,M0201,M0201,
M0202,M0202,M0201,M0201,M0201,M0200,M0200,M0200,M0202,M0200,M0200,M0200,M0200,
M0200,M0202,M0201,M0201,M0201,M0200,M0200,M0202,M0202,M0202,M0201,M0201,M0201,
M0201,M0201,M0201,M0200,M0200,M0200,M0201,M0202,M0202,M0200,M0200,M0200,M0201,
M0201,M0201,M0201,M0200,M0200,M0200,M0201,M0201,M0200,M0200,M0200,M0200,M0200,
M0201,M0201,M0201,M0200,M0202,M0202,M0200,M0200,M0200,M0200,M0200,M0202,M0201,
M0200,M0200,M0200,M0200,M0202,M0200,M0200,M0200,M0200,M0200,M0202,M0202,M0201,
M0200,M0200,M0200,M0200,M0200,M0200,M0202,M0202,M0201,M0200,M0200,M0202,M0201,
W0200,M0201,M0201,M0201,M0200,M0200,M0200,M0202,M0201,M0200,M0200,M0201,M0201,
W0200,W0200,M0201,M0200,M0200,M0200,M0201,M0200,M0200,M0202,M0202,M0200,M0200,
W0200,W0200,M0200,M0202,M0202,M0200,M0200,M0200,M0201,M0202,M0202,M0200,M0200,
W0200,W0200,W0200,M0202,M0202,M0201,M0200,M0200,M0200,M0201,M0201,M0200,M0200,
M0201,M0201,W0200,W0200,M0201,M0201,M0200,M0202,M0202,M0200,M0202,M0202,M0200,
M0201,M0201,M0200,W0200,W0200,W0200,M0200,M0200,M0202,M0200,M0200,M0200,W0200,
M0200,M0200,M0202,M0202,M0201,W0200,W0200,W0200,M0200,M0200,M0200,M0200,W0200,
M0202,M0200,M0200,M0202,M0201,M0201,M0200,W0200,W0200,W0200,M0200,W0200,W0200,
M0201,M0202,M0200,M0200,M0201,M0200,M0200,M0202,W0200,W0200,W0200,W0200,W0200,
M0202,M0200,M0200,M0200,M0200,M0200,M0200,M0201,M0202,W0200,W0200,W0200,M0200,
M0200,M0201,M0202,M0202,M0200,M0200,M0200,M0201,M0201,M0201,W0200,W0200,M0200,
M0200,M0201,M0202,M0202,M0200,M0200,M0200,M0201,M0201,W0200,W0200,M0200,M0201,
M0200,M0201,M0201,M0200,M0200,M0200,M0200,M0202,M0200,W0200,W0200,M0201,M0201,
M0200,M0200,M0200,M0200,M0200,M0202,M0202,M0202,M0200,W0200,M0200,M0201,M0200