-----,-----,-----,-----,-----,M0102,M0102,M0102,M0102,M0102,-----,-----,-----,-----,-----,-----,-----
-----,-----,-----,M0102,M0102,M0102,M0102,M0102,M0102,M0102,M0102,M0102,-----,-----,-----,-----,-----
-----,M0102,M0102,M0102,M0102,M0102,M0102,M0102,M0102,M0101,M0102,M0102,M0102,-----,-----,-----,-----
M0102,M0102,M0102,M0102,M0102,M0102,M0102,M0101,M0101,M0101,M0102,M0102,M0102,M0102,-----,-----,-----
M0102,M0102,M0102,M0102,M0101,M0101,M0101,M0101,M0101,M0101,M0101,M0102,M0102,M0102,M0102,-----,-----
M0102,M0102,M0102,M0101,M0101,M0100,M0100,M0100,M0101,M0101,M0101,M0101,M0101,M0102,M0102,M0102,-----
M0102,M0102,M0101,M0101,M0100,M0100,M0100,M0100,M0100,M0100,M0100,M0101,M0101,M0101,M0101,M0102,M0102
M0102,M0102,M0101,M0100,M0100,M0100,M0100,M0100,M0100,M0100,M0100,M0100,M0100,M0101,M0101,M0102,M0102
M0102,M0101,M0101,M0100,M0100,M0100,M0100,M0100,M0100,M0100,M0100,M0100,M0100,M0100,M0101,M0101,M0102
M0101,M0101,M0100,M0100,M0100,M0100,M0100,M0100,M0100,M0100,W0200,P0200,M0100,M0100,M0100,M0101,M0101
M0101,M0100,M0100,M0100,M0100,M0100,M0100,P0200,W0200,W0200,W0200,W0200,P0200,M0100,M0100,M0100,M0101
M0100,M0100,M0100,M0100,M0100,P0200,W0200,W0200,W0200,W0100,W0100,W0200,W0200,P0200,M0100,M0100,M0100
M0100,M0100,M0100,M0100,P0200,W0200,W0200,W0100,W0100,W0100,W0100,W0100,W0200,P0200,M0100,M0100,M0100
-----,M0100,M0100,M0100,P0200,W0200,W0100,W0100,W0100,W0100,W0200,W0200,M0100,M0100,M0100,M0100,M0100
-----,M0100,M0100,M0100,M0100,P0200,W0200,W0200,W0200,W0200,W0200,M0100,M0100,M0100,M0100,M0100,M0100
-----,-----,M0100,M0100,M0100,M0100,M0100,M0100,W0200,P0200,M0100,M0100,M0100,M0100,M0100,M0100,M0100
-----,-----,M0100,M0100,M0100,M0100,M0100,M0100,M0100,M0100,M0100,M0100,M0100,M0100,M0100,M0100,M0101
-----,-----,M0100,M0100,M0100,M0100,M0100,M0100,M0100,M0100,M0100,M0100,M0100,M0100,M0100,M0100,M0101
-----,-----,-----,M0100,M0100,M0100,M0100,M0100,M0100,M0100,M0100,M0100,M0100,M0100,M0100,M0101,M0101
-----,-----,-----,-----,-----,M0100,M0100,M0100,M0100,M0100,M0100,M0100,M0100,M0101,M0101,M0101,M0101
-----,-----,-----,-----,-----,-----,-----,M0100,M0100,M0100,M0100,M0100,M0101,M0101,M0101,M0101,M0102
-----,-----,-----,-----,-----,-----,-----,-----,-----,M0100,M0100,M0101,M0101,M0101,M0101,M0102,M0102