Index,Triggers,ActivePhase,AreaInfo(Trig3/4),,,,,,,,,,,,,,,,,,,,,,
1,2,3,0,0,,,,,,,
2,2,3,0,0,,,,,,,
3,5,0,0,0,,,,,,,
4,5,0,0,0,,,,,,,
5,6,0,0,0,,,,,,,
6,6,0,0,0,,,,,,,
7,1,0,0,0,,,,,,,
8,1,0,0,0,,,,,,,

