Index,Triggers,ActivePhase,AreaInfo(Trig3/4),,,,,,,,,,,,,,,,,,,,,,
1,1,0,0,0,LeftUp
2,1,0,0,0,LeftUp
3,1,0,0,0,LeftUp
4,1,0,0,0,LeftUp
5,1,0,0,0,LeftUp
6,1,0,0,0,LeftUp
7,1,0,0,0,LeftUp
8,1,0,0,0,LeftUp