M0300,P0500,P0500,P0500,P0500,P0500,P0500,P0500,P0500,P0500,P0500,P0500,P0500,P0500,P0500
M0300,M0300,P0500,P0500,P0500,P0500,P0500,P0500,P0500,P0500,P0500,P0500,P0500,P0500,P0500
M0300,M0300,M0300,P0500,P0500,P0500,P0500,P0500,P0500,P0500,P0500,P0500,P0500,P0500,P0500
M0300,M0300,M0300,P0500,P0500,P0500,P0500,P0500,P0500,P0500,P0500,P0500,P0500,P0500,P0500
M0300,M0300,M0300,M0300,P0500,P0500,P0500,P0500,P0500,P0500,P0500,P0500,P0500,P0500,P0500
M0300,M0300,M0300,M0300,P0500,P0500,P0500,P0500,P0500,P0500,P0500,P0500,P0500,P0500,P0500
M0300,M0300,M0300,M0300,M0300,P0500,P0500,P0500,P0500,P0500,P0500,P0500,P0500,P0500,P0500
M0300,M0300,M0300,M0300,M0300,P0500,P0500,P0500,P0500,P0500,P0500,P0500,P0500,P0500,P0500
M0300,M0300,M0300,M0300,M0300,P0500,P0500,P0500,P0500,P0500,P0500,P0500,P0500,P0500,P0500
M0300,M0300,M0300,M0300,M0300,M0300,P0500,P0500,P0500,P0500,P0500,P0500,P0500,P0500,P0500
P0500,M0300,M0300,M0300,M0300,M0300,P0500,P0500,P0500,P0500,P0500,P0500,P0500,P0500,P0500
P0500,P0500,M0300,M0300,M0300,M0300,P0500,P0500,P0500,P0500,P0500,P0500,P0500,P0500,P0500
P0500,P0500,M0300,M0300,M0300,M0300,P0500,P0500,P0500,P0500,P0500,P0500,P0500,P0500,P0500
P0500,P0500,P0500,M0300,M0300,M0300,M0300,P0500,P0500,P0500,P0500,P0500,P0500,P0500,P0500
P0500,P0500,P0500,M0300,M0300,M0300,M0300,P0500,P0500,P0500,P0500,P0500,P0500,P0500,P0500
P0500,P0500,M0300,M0300,M0300,M0300,M0300,P0500,P0500,P0500,P0500,P0500,P0500,P0500,P0500
P0500,P0500,M0300,M0300,M0300,M0300,M0300,P0500,P0500,P0500,P0500,P0500,P0500,P0500,P0500
P0500,P0500,P0500,M0300,M0300,M0300,M0300,M0300,P0500,P0500,P0500,P0500,P0500,P0500,P0500
P0500,P0500,P0500,M0300,M0300,M0300,M0300,M0300,P0500,P0500,P0500,P0500,P0500,P0500,P0500
P0500,P0500,P0500,P0500,M0300,M0300,M0300,M0300,P0500,P0500,P0500,P0500,P0500,P0500,P0500
P0500,P0500,P0500,P0500,M0300,M0300,M0300,M0300,M0300,P0500,P0500,P0500,P0500,P0500,P0500
P0500,P0500,P0500,P0500,M0300,M0300,M0300,M0300,M0300,P0500,P0500,P0500,P0500,P0500,P0500
P0500,P0500,P0500,P0500,M0300,M0300,M0300,M0300,M0300,M0300,P0500,P0500,P0500,P0500,P0500