P0300,P0300,P0300,P0300,P0300,P0300,P0300,P0300,P0300,P0300,P0300,P0300,P0300,P0300,P0300
P0300,P0300,P0300,P0300,P0300,P0300,P0300,P0300,P0300,P0300,P0300,P0300,P0300,P0300,P0300
P0300,P0300,P0300,P0300,P0300,P0300,P0300,P0300,P0300,P0300,P0300,P0300,P0300,P0300,P0300
P0300,P0300,P0300,P0300,P0300,P0300,P0300,P0300,P0300,P0300,P0300,P0300,P0300,P0300,P0300
P0300,P0300,P0300,P0300,P0300,P0300,P0300,P0300,P0300,P0300,P0300,P0300,P0300,P0300,P0300
P0300,P0300,P0300,P0300,P0300,P0300,P0300,P0300,P0300,P0300,P0300,P0300,P0300,P0300,P0300
P0300,P0300,P0300,P0300,P0300,P0300,P0300,P0300,P0300,P0300,P0300,P0300,P0300,P0300,P0300
P0300,P0300,P0300,P0300,P0300,P0300,P0300,P0300,P0300,P0300,P0300,P0300,P0300,P0300,P0300
P0300,P0300,P0300,P0300,P0300,P0300,P0300,P0300,P0300,P0300,P0300,P0300,P0300,P0300,P0300
P0300,P0300,P0300,P0300,P0300,P0300,P0300,P0300,P0300,P0300,P0300,P0300,P0300,P0300,P0300
P0300,P0300,P0300,P0300,P0300,P0300,P0300,P0300,P0300,P0300,P0300,P0300,P0300,P0300,P0300
P0300,P0300,P0300,P0300,P0300,P0300,P0300,P0300,P0300,P0300,P0300,P0300,M0300,M0300,M0300
P0300,P0300,P0300,P0300,P0300,P0300,P0300,P0300,P0300,P0300,P0300,M0300,M0300,M0300,M0300
P0300,P0300,P0300,P0300,P0300,P0300,P0300,P0300,P0300,P0300,M0300,M0300,M0300,M0300,M0300
P0300,P0300,P0300,P0300,P0300,P0300,P0300,P0300,M0300,M0300,M0300,M0300,M0300,M0300,M0300
P0300,P0300,P0300,P0300,M0300,M0300,M0300,M0300,M0300,M0300,M0300,M0300,M0300,M0300,P0300
P0300,P0300,P0300,M0300,M0300,M0300,M0300,M0300,M0300,M0300,M0300,M0300,M0300,P0300,P0300
P0300,P0300,M0300,M0300,M0300,M0300,M0300,M0300,M0300,M0300,M0300,M0300,P0300,P0300,P0300
P0300,M0300,M0300,M0300,M0300,M0300,M0300,M0300,P0300,P0300,P0300,P0300,P0300,P0300,P0300
M0300,M0300,M0300,M0300,M0300,M0300,P0300,P0300,P0300,P0300,P0300,P0300,P0300,P0300,P0300
M0300,M0300,M0300,M0300,M0300,P0300,P0300,P0300,P0300,P0300,P0300,P0300,P0300,P0300,P0300
M0300,M0300,M0300,M0300,M0300,P0300,P0300,P0300,P0300,P0300,P0300,P0300,P0300,P0300,P0300
M0300,M0300,M0300,M0300,P0300,P0300,P0300,P0300,P0300,P0300,P0300,P0300,P0300,P0300,P0300